1121	212	210	213	100	310	100	0	1111	0	200
0	100	100	100	100	3100	100	0	1112	0	201
0	0	0	0	0	0	100	0	1111	3010	301
100	100	1132	100	100	0	100	100	1121	100	100
0	1112	1132	1112	100	0	1121	0	0	0	0
200	0	0	1121	100	0	100	100	100	100	1121
200	0	1122	231	100	0	100	0	0	0	0
200	0	0	1121	100	0	100	0	0	0	0
0	0	0	0	100	0	100	1111	1111	0	0
100	100	0	0	100	0	100	112	0	211	211
300	3000	0	201	100	111	113	230	1141	212	212
