100	100	100	100	100	300	100	0	0	213	3300
100	210	212	201	1111	3000	113	0	0	213	211
100	210	212	0	1111	0	100	0	0	213	211
100	210	212	0	1111	0	100	0	0	1112	200
100	210	212	0	1111	0	100	1112	1112	1112	202
100	110	100	100	100	0	100	113	100	100	100
112	212	212	210	100	0	100	213	213	0	100
112	112	212	210	100	113	100	213	213	0	100
112	101	212	210	100	0	100	213	213	210	100
222	101	212	210	100	0	100	213	213	210	100
100	100	100	100	100	998	100	100	100	100	100
